Rows,Blue, Red, Green, Yellow, Purple, Pink
Cow,0,15,30,45,60,75
Zebra,0,-10,-20,-30,-40,-50
Lion,0,-20,-40,-60,-80,-100
Tiger ,0,-20,-40,-60,-80,-100
Bear,0,-6,-12,-18,-24,-30
Horse,0,- 14 ,-28,-42,-56,-70
Dog,0,250,500,750,1000,1250
Cat,0,3,6,9,12,15
Monkey,0,50,100,150,200,250
Elephant,0,-4,-8,-12,-16,-20
Raccoon,0,-6,-12,-18,-24,-30
